,,,,,,,,,,
,w,,,,,,,,
,v,,,,,,,,
,v,,,@,,,,
,v,,,,,,,,
,v,,,,,,,,
,v,,,g,,,,
,,,,,,,,,,