,,,,,,,,,,,,,,,,,,,,
,,,,,,,,,,,,,,,,,,,,
,,,,,,,,,,,,,,,,,,,,
,,,,,,,,,,,,,,,,,,,,
,,,,,zzzzzzzzzzz,,,,
,,,,,zupppppppiz,,,,
,,,,,zP,,,,,,,Pz,,,,
,,,,,zP,,,,,,,Pz,,,,
,,,,,zPzzz@zzzPz,,,,
,,,,,zP,,,,,,,Pz,,,,
,,,,,zP,,,,,,,Pz,,,,
,,,,,zP,,,C,,,Pz,,,,
,,,,,zP,,,,,,,Pz,,,,
,,,,,zUpppppppIz,,,,
,,,,,zzzzzzzzzzz,,,,
,,,,,,,,,,,,,,,,,,,,
,,,,,,,,,,,,,,,,,,,,
,,,,,,,,,,,,,,,,,,,,